NO ./image/wall_n.xpm
SO ./image/wall_s.xpm
WE ./image/wall_w.xpm
EA ./image/wall_e.xpm

F 255,255,25
C 144,144,252

11111111111
10000100001
10000000001
10000000001
10000100001
10001E11001
10000000001
10000000001
10000000001
10000000001
11111111111