EA /mnt/nfs/homes/jralph/Desktop/Cub3d/image/wall_e.xpm
NO /mnt/nfs/homes/jralph/Desktop/Cub3d/image/wall_n.xpm
SO /mnt/nfs/homes/jralph/Desktop/Cub3d/image/wall_s.xpm
WE /mnt/nfs/homes/jralph/Desktop/Cub3d/image/wall_w.xpm

F 255,255,25
C 144,144,252

11111111111
10000100001
10000000001
10000000001
10000100001
10001N11001
10000000001
10000000001
10000000001
10000000001
11111111111
