NO ./image/wall_n.xpm
SO ./image/wall_s.xpm
WE ./image/wall_w.xpm
EA ./image/wall_e.xpm

F 255,255,25
C 144,144,252

11111111111111111111111111111111
11111111111111111111111111111111
11111111111111111111111111111111
11111111100000000000111111111111
11111111000000000000011111111111
11111110000000000000001111111111
11111100000000N00000000111111111
11111100000000000000000111111111
11111110000000000000001111111111
11111111000000000000011111111111
11111111100000000000111111111111
11111111111111111111111111111111
11111111111111111111111111111111